frames 1
width 30
height 6
color yellow
  _                    _   __ 
 | |                  | | /_ |
 | |     _____   _____| |  | |
 | |    / _ \ \ / / _ \ |  | |
 | |___|  __/\ V /  __/ |  | |
 |______\___| \_/ \___|_|  |_|
end
eof
