frames 1
width 28
height 6
color yellow
  _____       _             
 |_   _|     | |            
   | |  _ __ | |_ _ __ ___  
   | | | '_ \| __| '__/ _ \ 
  _| |_| | | | |_| | | (_) |
 |_____|_| |_|\__|_|  \___/ 
end
eof
